51;5;10
00000000000000000000000000000000000000000000000000
0                                                D
DX                                              ED
0                                                D
00000000000000000000000000000000000000000000000000
"Where the F am I ?"